S.##......
#.##..###.
#.###.###.
#.....###.
###.#####S

